NO ./img/onepiece_wall_chopper.png
SO ./img/onepiece_wall_nami.png
EA ./img/onepiece_wall_monkey.png
WE ./img/onepiece_wall_nico.png

C 9, 24, 51
F 48, 27, 104

111111111111
100000000001
1010001101101111111111
1010010000000000000001
1000111110000000000001
10000000000000000000011
1001111110000000000000001
1000000000N0111111111111
111111111111